.........................
.........................
.........................
.........................
.........................
.........................
.........................
.........................
.........................
.........................
.........................
.........................
.........................
.....B?MFo...............
.........................
..........BBB............
.........................
.........................
BBBBBBBBBBBBBBBBBBBBBBBBB
